1. ALMACHE CUEVA MARIO GEOVANNY	[SI]
2. ALMEIDA ENCALADA OSWALDO WLADIMIR	[NO]
3. ALVAREZ GIMENEZ MAYRA ISABEL	[SI]
4. AREVALO NAVARRETE SILVIA MAYTE	[SI]
5. ARGUELLO RAMOS MILTON LEONARDO	[SI]
6. ARROYO CHANGO RUBEN DARIO	[SI]
7. BALDEON ANDRADE ALEXANDER OMAR	[NO]
8. BONILLA VERGARA MARCO ANTONIO	[NO]
9. CAIZAGUANO CHIMBO CARLOS OSVALDO	[SI]
10. CARRION SAMPEDRO EDGAR VINICIO	[NO]
18. CARDENAS DELGADO SONIA ELIZABETH [SI]
11. CHICHAIZA ANGAMARCA DORIS KARINA	[SI]	
12. CHILIQUINGA MENDOZA CESAR IVAN	[SI]
13. CUDCO POMAGUALLI ANGEL GEOVANNY	[SI]
14. CUSCO VINUEZA VICTOR ALFONSO	[SI]
15. DE LA TORRE DAVALOS CESAR DAVALOS	[SI]
16. DE LA TORRE DIAZ EDISON ANDRES	[SI]
17. DIAZ ZUÑIGA MAGI POMAGUALLI	[SI]
19. GALARRAGA HURTADO JUAN FERNANDO	[SI]
20. GAMBOA SAFLA DIEGO LEONARDO	[SI]
21. GOMEZ SALAZAR MONICA ELIZABETH	[SI]
22. GOMEZ TORRES ESTEVAN RICARDO	[SI]
23. GUAYASAMIN GUANGA CESAR ADRIAN	[SI]
24. GUSTAVO SANCHEZ CHRISTIAN SANTIAGO	[NO]
25. JAMARILLO MONTAÑO LUIS ENRIQUE	[SI]
26. LASCANO JORGE EDISON	[SI]
27. LOACHAMIM VALENCIA MAURICIO RENAN	[SI]
28. LOPEZ LOPEZ ANDREA MARGARITA	[SI]
29. LOZA HERRERA WASHINGTON EDUARDO	[SI]
30. MALDONADO GUACHAMIN STALIN BOLIVAR	[NO]
31. MERCHAN RODRIGUEZ VICENTE ROLANDO	[SI]
32. MONTENEGRO ARMAS CARLOS ESTALESMIT	[NO]
33. MORALES CAIZA DARIO JAVIER	[SI]
34. OSORIO AGUALONGO CESAR OSWALDO	[SI]
35. PARRA MOREIRA PABLO XAVIER	[SI]
36. PESANTEZ ALDAS ROSA CRISTINA	[SI]
37. PILLAJO BOLAGAY CARLOS ANDRES	[SI]
38. PINTO PACHACAMA HECTOR PAUL [SI]
39. QUINDE ENDARA EMILIO JOSE	[NO]
40. QUISHPE TOPON ANDRES FRANCIS	[NO]
41. REA GUAMAN ANGEL MARCELO	[SI]
42. RIVERA GONZALEZ MARCO DAVID	[NO]
43. RON EGAS MARIO BERNABE	[SI]
44. RUIZ ROBALINO JENNY ALEXANDRA	[SI]
45. SAAVEDRA GARCIA DIEGO MEDARDO	[SI]
46. SALAZAR CHACON GUSTAVO DAVID	[SI]
47. SALAZAR MORALES CRISTINA VICTORIA	[NO]
48. SANCHO ARIAS JOSE ALBERTO	[NO]
49. SOLIS ACOSTA EDGAR FERNANDO	[SI]
50. TAIPE CAIZAPANTA MARIA EMILIA	[TEST]
51. TAPIA LEON FREDDY MAURICIO	[SI]
52. VALDIVIESO LOPEZ WELLINGTON ERNESTO	[SI]
53. VALENCIA STACEY IVAN SANTIAGO	[SI]	
54. VILLACIS SILVA CESAR JAVIER	[SI]
55. VINUEZA PAZ PATRICIO ENRIQUE	[SI]
56. ZAMBRANO BALSECA CHARLES DAVID	[TEST]
57. ZAMBRANO RIVERA MARGARITA ELIZABETH	[SI]